National Institute of Standards and Technology Cybersecurity Framework is a voluntary framework consist of standards, guidelines, and best practices to manage cybersecurity risks.

HIPPA - Health Insurance Portability and Accountability Act)
PII - Personally Identifiable Information
SPII - Sensitive personally identifiable information
PHI - Protected Health Information
GDPR - General Data Protection Regulation
PCI DSS - Payment Card Industry Data Security Standard
FIPS - Federal Information Processing Standardd

sha256 - hashing
LDAP - Lightweight Directory Access Protocol
SAML - Security Assertion Markup Language
IAM - Identity and Access Manaagement
MAC - Mandatory Access Control
DAC - Discretionary Access Control
RBAC - Role-based Access Control

Vulnerability - is a weakness that can be exploited by a threat
Exposure - is a mistake that can be exploited by a threat
CVE list (Common Vulnerabilities and Exposures list) - an openly accessible dictionary of known vulnerabilities and exposures

CNA (CVE Numbering Authority) - an organization that volunteers to analyze and distribute information on eligible CVEs

OWASP - Open WorldWide Application Security Project

OSINT - Open-source intelligence 

CISA - Cybersecurity and Infrastruture Security Agency

Penetration test - is a simulated attack that helps identify vulnerabilities in systems, networks, websites, application, and processes.

Threat actor - is any person or group who presents a security risk.

hacker - is any person who uses computers to gain unauthorized access to computer systems, networks, or data.

brute force attacks - are trial-and-error process of discovering private information.

Social engineering - a manipulation technique that exploits human error to gain private information, access, or valuables.

Phishing - the use of digital communications to trick people into revealing sensitive data or deploying malicious software

Malware - are software that are designed to harm devices or networks

PUA - potentially unwanted application

XSS - Cross-site scripting

PASTA - Process for Attack Simulation and Threat Analysis

SSl/TLS (Secure Sockets Layer/Transport Layer Security - are cryptographic protocols designed to provide secure communication over a network.

SIEM - Security Information and Event Management

Documentation - is any form of recorded content that is used for a specific purpose

Playbook - a manual that provides details about any operational action

SOAR - Security orchestration, automation, and response

Cyber deception
Cyber deception involves techniques that deliberately deceive malicious actors with the goal of increasing detection and improving defensive strategies.